  cell  ,E,W,N,S
"(1, 1)",1,0,0,1
"(2, 1)",1,0,1,0
"(3, 1)",1,0,0,1
"(4, 1)",1,0,1,0
"(5, 1)",1,0,0,1
"(6, 1)",0,0,1,1
"(7, 1)",0,0,1,0
"(1, 2)",1,1,0,0
"(2, 2)",0,1,0,1
"(3, 2)",0,1,1,0
"(4, 2)",1,1,0,0
"(5, 2)",0,1,0,1
"(6, 2)",0,0,1,1
"(7, 2)",1,0,1,0
"(1, 3)",1,1,0,0
"(2, 3)",0,0,0,1
"(3, 3)",0,0,1,1
"(4, 3)",1,1,1,1
"(5, 3)",0,0,1,1
"(6, 3)",0,0,1,1
"(7, 3)",1,1,1,0
"(1, 4)",1,1,0,0
"(2, 4)",1,0,0,1
"(3, 4)",1,0,1,0
"(4, 4)",0,1,0,1
"(5, 4)",0,0,1,1
"(6, 4)",0,0,1,1
"(7, 4)",1,1,1,0
"(1, 5)",1,1,0,1
"(2, 5)",0,1,1,0
"(3, 5)",1,1,0,0
"(4, 5)",1,0,0,1
"(5, 5)",0,0,1,1
"(6, 5)",1,0,1,1
"(7, 5)",1,1,1,0
"(1, 6)",1,1,0,0
"(2, 6)",1,0,0,1
"(3, 6)",0,1,1,0
"(4, 6)",1,1,0,0
"(5, 6)",1,0,0,0
"(6, 6)",1,1,0,0
"(7, 6)",1,1,0,0
"(1, 7)",0,1,0,0
"(2, 7)",0,1,0,1
"(3, 7)",0,0,1,1
"(4, 7)",0,1,1,1
"(5, 7)",0,1,1,0
"(6, 7)",0,1,0,1
"(7, 7)",0,1,1,0